xxxxxxxxxxxxx
x...........x
x.///...///.x
x./o/.s./o/.x
x.///.x.///.x
x...........x
x.o/o/o/o/o.x
x.....p.....x
xxxxxxxxxxxxx
