xxxxxxxxxxx
xxxxxoxxxxx
xx.xxoxx.xx
xx..xsx..xx
xx.......xx
xx.......xx
xx.......xx
xx.......xx
xx.......xx
xx.......xx
xx.......xx
xx.......xx
xx.......xx
xx.......xx
xx.......xx
xx.......xx
xx.......xx
xx.......xx
xx...p...xx
xxxxxxxxxxx