xxxxxxxxxxxxx
x....s......x
x...........x
x...........x
x...../.....x
x.....p.....x
x...........x
x...........x
xxxxxxxxxxxxx